..............................................................................................g...........................................................................................................................................
.............................................................................................&G...........................................................................................................................................
..........................................................................................&...g..&.........&..............................................................................................................................
..................................................................................&..........&G.....................&.............&.......................................................................................................
.................................................g...............&............................g.....&.....................................................................................................................................
...........................&.......&...&........g.k........................&..................z............b...f..........................................................................................................................
.................................&.............g.{}....&.....&...................&...........G=G.........."""""""""".........p...bp....P..................................................................................................
..........&..........&....................&....g.........................&..................g=.=g.........,,,,,,,,,,........====================..........................................................................................
................&............gg......&.........g..&...............&........................G=...=G........,,,,,,,,,,......................................................................................................................
.......&...................gg....?........h....g.............G............................g=.....=g......"""""""""""".....................................................................................................................
................+.........g....<"">........3P..z.......2....GBG..HGG.....................G=.......=G.....,,,,,!o!,,,,.....................................................................................................................
...................b....p................<""""">........PP.GBBBG..BB.....g.g.g.g.g.g.g...=.........=.....,,,,,,O,,,,,.z...................................................................................................................
~~~~~~~~~~~~~~~<"""""""""">~~~~~~~~~~~~~~~~~~~~~~~~~~~<"""""""""""""">~~~~~~~~~~~~~~~~~~~~~~~~~~~~~~~~~<"""""""""""""">~~~~~~~~~~~~~~~~~~~~~~~~~~~~~~~~~~~~~~~~~~~~~~~~~~~~~~~~~~~~~~~~~~~~~~~~~~~~~~~~~~~~~~~~~~~~~~~~~~~~~~~~~~~~~~~~~~~
------------------------------------------------------------------------###############---------------------------------------------------------------------------------------------------------------------------------------------------
------------------------------------------------------------------------------------------------------------------------------------------------------------------------------------------------------------------------------------------
------------------------------------------------------------------------------------------------------------------------------------------------------------------------------------------------------------------------------------------
------------------------------------------------------------------------------------------------------------------------------------------------------------------------------------------------------------------------------------------
------------------------------------------------------------------------------------------------------------------------------------------------------------------------------------------------------------------------------------------
------------------------------------------------------------------------------------------------------------------------------------------------------------------------------------------------------------------------------------------
------------------------------------------------------------------------------------------------------------------------------------------------------------------------------------------------------------------------------------------
------------------------------------------------------------------------------------------------------------------------------------------------------------------------------------------------------------------------------------------
^^^^^^^^^^^^^^^^^^^^^^^^^^^^^^^^^^^^^^^^^^^^^^^^^^^^^^^^^^^^^^^^^^^^^^^^^^^^^^^^^^^^^^^^^^^^^^^^^^^^^^^^^^^^^^^^^^^^^^^^^^^^^^^^^^^^^^^^^^^^^^^^^^^^^^^^^^^^^^^^^^^^^^^^^^^^^^^^^^^^^^^^^^^^^^^^^^^^^^^^^^^^^^^^^^^^^^^^^^^^^^^^^^^^^^^^^^